.....++.....
...++##+...+
....+++..++#
........+##+
...++++.....
....++...+..
.+......++++
.#+...++##++
.++..++###++
.....++#++..
.+..++#+....
.+...++..++.
...+.....+#+
...++.++...+
.+..+..++...
.+.......++.
.....+....+.
.++.+++..++
.++..+++...+
.+......+...
......+.....
......+++...
.+..+++#+...
.#+..+###+..
.##+...+##++
.++..++###++
....+######+
....+#######
..+..+######
.++..++++##+
..+....++++.
....+...++..
...+++..+..+
...+##+...++
....+##+..+#
..+..+++...+
.++...+..+++
.#++.......+
.##++.+..++.
.##+..++.+#+
.##+..+...++
.++..+......
....+++.++..
..++.+#+#++.
..+...+.+++.
.+..++..++.+
.#+.+....+.+
.+..++..+#..
...+..+..+..
..+#+.......
...+#+..++..
....+..+#+..
.++.....+..+
....++....++
...+##+..++#
+...++.....+
#+.....++...
##+...++#+..
++...+###+..
.....+##++..
......+++...
............